XSXXXXXX.X
......X..X
.X.XX.XX.X
.X........
XX.XX.XXXX
....X....X
.XXXXXXX.X
....X.....
.XXXX.XXX.
....X...GX